姓名,工资收入金额,养老保险费,医疗保险费,失业保险费,工伤保险费,生育保险费
张三,2000,200,160,40,15,8
李四,4000,300,240,60,20,10
王五,7000,500,400,100,30,15
赵六,10000,800,640,160,50,25
钱七,15000,1200,960,240,70,35
孙八,20000,1600,1280,320,90,45
周九,25000,2000,1600,400,110,55
吴十,30000,2400,1920,480,130,65
刘十一,35000,2800,2240,560,150,75
陈十二,40000,3200,2560,640,170,85
杨十三,45000,3600,2880,720,190,95
黄十四,50000,4000,3200,800,210,105
朱十五,55000,4400,3520,880,230,115
曾十六,60000,4800,3840,960,250,125